"filename", "language", "HTML", "JavaScript", "CSS", "comment", "blank", "total"
"/home/jklijzing/BrBaGame.github.io/about.html", "HTML", 29, 0, 0, 0, 4, 33
"/home/jklijzing/BrBaGame.github.io/balance.html", "HTML", 32, 0, 0, 0, 4, 36
"/home/jklijzing/BrBaGame.github.io/css/hamburgers.css", "CSS", 0, 0, 534, 100, 72, 706
"/home/jklijzing/BrBaGame.github.io/css/style.css", "CSS", 0, 0, 177, 0, 39, 216
"/home/jklijzing/BrBaGame.github.io/game/game.css", "CSS", 0, 0, 171, 0, 32, 203
"/home/jklijzing/BrBaGame.github.io/game/s1/e1.html", "HTML", 150, 0, 0, 0, 29, 179
"/home/jklijzing/BrBaGame.github.io/game/s1/e1.js", "JavaScript", 0, 433, 0, 0, 104, 537
"/home/jklijzing/BrBaGame.github.io/game/s1/e1_dialogs.js", "JavaScript", 0, 426, 0, 0, 0, 426
"/home/jklijzing/BrBaGame.github.io/game/s1/ep1.css", "CSS", 0, 0, 153, 0, 28, 181
"/home/jklijzing/BrBaGame.github.io/help.html", "HTML", 26, 0, 0, 0, 4, 30
"/home/jklijzing/BrBaGame.github.io/index.html", "HTML", 27, 0, 0, 0, 4, 31
"/home/jklijzing/BrBaGame.github.io/js/about.js", "JavaScript", 0, 143, 0, 0, 7, 150
"/home/jklijzing/BrBaGame.github.io/js/balance.js", "JavaScript", 0, 23, 0, 0, 6, 29
"/home/jklijzing/BrBaGame.github.io/js/navbar.js", "JavaScript", 0, 28, 0, 0, 6, 34
"/home/jklijzing/BrBaGame.github.io/js/script.js", "JavaScript", 0, 3, 0, 0, 0, 3
"/home/jklijzing/BrBaGame.github.io/season1.html", "HTML", 30, 0, 0, 0, 4, 34
"/home/jklijzing/BrBaGame.github.io/seasons.html", "HTML", 29, 0, 0, 0, 4, 33
"/home/jklijzing/BrBaGame.github.io/shop.html", "HTML", 40, 0, 0, 0, 4, 44
"/home/jklijzing/BrBaGame.github.io/shop/blue_meth.html", "HTML", 47, 0, 0, 0, 4, 51
"/home/jklijzing/BrBaGame.github.io/shop/diy_meth.html", "HTML", 47, 0, 0, 0, 4, 51
"/home/jklijzing/BrBaGame.github.io/shop/pollos_piezas.html", "HTML", 47, 0, 0, 0, 4, 51
"/home/jklijzing/BrBaGame.github.io/shop/saul_goodman.html", "HTML", 47, 0, 0, 0, 4, 51
"/home/jklijzing/BrBaGame.github.io/shop/shop.js", "JavaScript", 0, 38, 0, 0, 13, 51
"Total", "-", 551, 1094, 1035, 100, 380, 3160